##################################
#..#................#............#
#..##............................#
#................................#
#................................#
##...............................#
###.............................##
##################################