#################
#.E#.H#.H.#H.#E.#
#..#..#HHH#..#..#
#.....##.##.....#
#..#..H.H.H..#..#
#..#####.#####..#
#..E.E.....E.E..#
#..E....E....E..#
#################