###############
#.......#.EEE.#
#..H....#..E..#
#H..#...#..EE.#
#HH.##........#
#H..#...#.....#
#.......###.###
#.H...........#
#.............#
###############